PPPPPPPPPPPPPPPPPPPPPPPPPPPPPPPPPPPPPPPPPPPPPPPPPPPPPPPPPPPPPPPPPPPPPPPPPPPPPPPPPPPPPPPPPPPPPPPPPPPPPPPPPPPPPPPPPPPPPPPP
P0000000000000000000000000000000000000000000000000000000000000000000000000000000000000000000000000000000000000000000000P
P0000000000000000000000000000000000000000000000T00000000000000000000000000000000000000000000000000000000000000000000000P
P0000000000000000000000000000000000000000000000000000000000000000000000000000000000000000000000000000000000000000000000P
P00000000000000T00000000000000000000000000PPPPPPPPPPPL00000PPPP00000000000000000000000000000000000000000000000000000000P
P00000000000000000000000000000000000000000PPPPPPPPPPPL00000PPPP00000000000000000000T00T00000000000000000000000000000000P
P00000000PPPPPPPPPPPPPPL00000000000000000000000000000L00000000000000000000000000000000000000000000000000000000000000000P
P00000000PPPPPPPPPPPPPPL000000T0000000000000000000000L00000000000000000000000000PPPPPPPPPL00000000000000000000000T00000P
P0000000000000000000000L00000000000000000000000000000L0T000000000000000000000000PPPPPPPPPL00000000000000000000000000000P
P0000000000000000000000L0000LPPPPPPPPP000000000000000L00000000LPPPPPPPP000000000000000000L000LPPPPPPPPPPPPPPPPPPPPPPPPPP
P0000000000000000000000L0000LPPPPPPPPP000000000PPPPPPPPPPPL000LPPPPPPPP000T00000000000000L000LPPPPPPPPPPPPPPPPPPPPPPPPPP
P0000000000000000000000L0000LPP0000000000000000PPPPPPPPPPPL000LPPPPPPPP0000000000000000T0L000LPP00000000000000000000000P
P000000LPPPPP00000000PPPP000LPP000000000LPPP00000000000000L000LPPPPPPPP00PPPP000000000000L000LPP00000000000000000000000P
P000000LPPPPP00000000PPPP000LPP000000000LPPP00000000000000L000LPPPPPPPP00PPPP000PPPPPPPPPP000LPP00000000000000000000000P
P000000L00000000000000000000LPP000000000LPPP00000000000000L000LPPPPPPPP000000000PPPPPPPPPP000LPP00000000000000000000000P
P000000L000000000T0000000000LPP0000T0000LPPP0T0000000T0000L000LPPPPPPPP0000000000000000000000LPP00000000000000000000000P
P000000L00000000000000000000LPP000000000LPPP00000000000000L000LPPPPPPPP0000000000000000000000LPP00000000000000000000000P
PPPPPPPPPPPPPPPPPPPPPPPPPPPPPPPPPPPPPPPPPPPPPPPPPPPPPPPPPPPPPPPPPPPPPPPPPPPPPPPPPPPPPPPPPPPPPPPPPPPPPPPPPPPPPPPPPPPPPPPP