PPPPPPPPPPPPPPPPPPPPPPPPPPPPPPPPPPPPPPPPPPPPPPPPPPPPPPPPPPPPPPPPPPPPPPPPPPPPPPPPPPPPPPPPPPPPPPPPPPPPPPPPPPPPPPPPPPPPPPPP
P00000000000000000000000PP00000000000000PP00000000000000PP00000000000000PP00000000000000PP00000000000000000000000000000P
P00000000000000000000000PP00000000000000PP0000000T000000PP00000000000000PP00000000000000PP0000000T000000000000000000000P
P00000000000000000000000PP00000000000000PP00000000000000PP00000000000000PP00000000000000PP00000000000000000000000000000P
P0000000000000LPPPPP0000000000LPPPPP0000000000LPPPPP0000000000LPPPPP0000000000LPPPPP0000000000LPPPPP0000000000000000000P
P0000000000000LPPPPP0000000000LPPPPP0000000000LPPPPP0000000000LPPPPP0000000000LPPPPP0000000000LPPPPP0000000000000000000P
P0000000000000L000PP0000000000L000PP0000000000L000PP0000000000L000PP0000000000L000PP0000000000L000PP0000000000000000000P
P0000000000000L0T0PP0000000000L0T0PP0000000000L0T0PP0000000000L0T0PP0000000000L0T0PP0000000000L0T0PP0000000000000000000P
P0000000000000L000PP0000000000L000PP0000000000L000PP0000000000L000PP0000000000L000PP0000000000L000PP0000000000000000000P
P0000000000000LPPPPP0000000000LPPPPP0000000000LPPPPP0000000000LPPPPP0000000000LPPPPP0000000000LPPPPP0000000000000000000P
P0000000000000LPPPPP0000000000LPPPPP0000000000LPPPPP0000000000LPPPPP0000000000LPPPPP0000000000LPPPPP0000000000000000000P
P0000000000000L000PP0000000000L000PP0000000000L000PP0000000000L000PP0000000000L000PP0000000000L000PP0000000000000000000P
P0000000000000L0T0PP0000000000L0T0PP0000000000L0T0PP0000000000L0T0PP0000000000L0T0PP0000000000L0T0PP0000000000000000000P
P0000000000000L000PP0000000000L000PP0000000000L000PP0000000000L000PP0000000000L000PP0000000000L000PP0000000000000000000P
P0000000000000LPPPPP0000000000LPPPPP0000000000LPPPPP0000000000LPPPPP0000000000LPPPPP0000000000LPPPPP0000000000000000000P
P0000000000000LPPPPP0000000000LPPPPP0000000000LPPPPP0000000000LPPPPP0000000000LPPPPP0000000000LPPPPP0000000000000000000P
P0000000000000LPPPPP0000000000LPPPPP0000000000LPPPPP0000000000LPPPPP0000000000LPPPPP0000000000LPPPPP0000000000000000000P
PPPPPPPPPPPPPPPPPPPPPPPPPPPPPPPPPPPPPPPPPPPPPPPPPPPPPPPPPPPPPPPPPPPPPPPPPPPPPPPPPPPPPPPPPPPPPPPPPPPPPPPPPPPPPPPPPPPPPPPP