PPPPPPPPPPPPPPPPPPPPPPPPPPPPPPPPPPPPPPPPPPPPPPPPPPPPPPPPPPPPPPPPPPPPPPPPPPPPPPPPPPPPPPPPPPPPPPPPPPPPPPPPPPPPPPPPPPPPPPPP
P00000000000000000000PPPPPPPPP00000000000000000000000000000000000000000000000000000000000000000000000000000000000000000P
P00000000000000000000PPPPPPPPP00000000000000000000000000000000000000000000000000000000000000000000000000000000000000000P
P00000000000000000000PPPPPPPPP00000000000000000000000000000000000000000000000000000000000000000000000000000000000000000P
P00000000000T00000000000000000000000000000000000000000000000000000T0000000000T00000000000000000000000000000000000000000P
P000000000000000000000T00000T000000000000000000000000000000000000000000000000000000000000000000000000000000000000000000P
P00000000LPPPPP000000000000000000000000000000000000000000000000000PPPPPPPPPPPP00000000000000000000000000000000000000000P
P00000000LPPPPP000000PPPPPPPPP00000000T0000000000000000000000000PPPP00000000PPPP000000000000000000000000000000000000000P
P00000000LPPPPP000000PPPPPPPPP00000000000000000000000000000000PPPP0000PPPP0000PPPP0000000000000000000000000000000000000P
P00000000L00000000000000000000000000PPPPPP000000000000000000PPPP0000PPPPPPPP000PPPPP00000000000000000000000000000000000P
P00000000L00000000000000000000000000PPPPPP000000000000T000PPPP0000PPPP0000PPPP0000PPPP000T0000000000000000T00000000T000P
P00000000L0000000000000000000000000000000000000000000000PPPP0000PPPP00000000PPPP0000PPPP0000000000000000000000000000000P
P00000000L00000000000000000000000000000000000000000000PPPP0000PPPP0000PPPP0000PPPP0000PPPP000000000000LPPPPPPPPPPPPPPPPP
P00000000L0000000PPPPPL00000PPL0000LPPP000000000T000PPPP0000PPPP0000PPPPPPPP0000PPPP0000PPPP000T000000LPPPPPPPPPPPPPPPPP
P00000000L0000000PPPPPL000PPPPL0000LPPP00000000000PPPP0000PPPP0000PPPP0000PPPP0000PPPP0000PPPP00000000LPPPPPPPPPPPPPPPPP
P00000000L000000000000L0PPPP00L0000LPPP00000000LPPPP0000PPPP0000PPPP00000000PPPP0000PPPP0000PPPPL00000LPPPPPPPPPPPPPPPPP
P00000000L000000000000L0PP0000L0000LPPP00000000LPPPP0000PPPP0000PPPP00000000PPPP0000PPPP0000PPPPL00000LPPPPPPPPPPPPPPPPP
PPPPPPPPPPPPPPPPPPPPPPPPPPPPPPPPPPPPPPPPPPPPPPPPPPPPPPPPPPPPPPPPPPPPPPPPPPPPPPPPPPPPPPPPPPPPPPPPPPPPPPPPPPPPPPPPPPPPPPPP