PPPPPPPPPPPPPPPPPPPPPPPPPPPPPPPPPPPPPPPPPPPPPPPPPPPPPPPPPPPPPPPPPPPPPPPPPPPPPPPPPPPPPPPPPPPPPPPPPPPPPPPPPPPPPPPPPPPPPPPP
P0000000000000000000000000000000000000000000000000000000000000000000000000000000000000000000000000000000000000000000000P
P0000000000000000000000000000000000000000000000000000000000000000000000000000000000000000000000000000000000000000000000P
P0000000000000000000000000000000000000000000000000000000000000000000000000000000000000000000000000000000000000000000000P
P0000000000000000000000000000000000000000000000000000000000000000000000000000000000000000000000000000000000000000000000P
P0000000000000000000000000000000000000000000000000000000000000000000000000000000000000000000000000000000000000000000000P
P000PPPPP00P000P00P000P000000PP0000000PP000P000000P0000P0P00PPPPP00P000P00PPPPP00P00P00P000000000000000P000000000000000P
P00000P0000P000P000P0P000000P0P0000000P0P00P00000P0P000P0P0000P0000PP00P00P000000P00P00P0000000000000P00P00000000000000P
P00000P0000PPPPP0000P0000000PPP0000000PP000P0000PPPPP000P00000P0000P0P0P00P0PPP00P00P00P0000000000000000P00000000000000P
P00000P0000P000P000P0P00000000P0000000P0000P0000P000P000P00000P0000P00PP00P000P0000000000000000000000P00P00000000000000P
P00000P0000P000P00P000P0000000P0000000P0000PPP00P000P000P000PPPPP00P000P00PPPPP00P00P00P000000000000000P000000000000000P
P0000000000000000000000000000000000000000000000000000000000000000000000000000000000000000000000000000000000000000000000P
P0000000000000000000000000000000000000000000000000000000000000000000000000000000000000000000000000000000000000000000000P
P0000000000000000000000000000000000000000000000000000000000000000000000000000000000000000000000000000000000000000000000P
P00000000000000000T0000T0000T0000T0000T0000T0000T0000T0000T0000T0000T0000T0000T00000000000000000000000000000T0000000000P
P0000000000000000000000000000000000000000000000000000000000000000000000000000000000000000000000000000000000000000000000P
P00000000000000000PP000PP000PP000PP000PP000PP000PP000PP000PP000PP000PP000PP000PP0000000000000000000000000000PP000000000P
PPPPPPPPPPPPPPPPPPPPPPPPPPPPPPPPPPPPPPPPPPPPPPPPPPPPPPPPPPPPPPPPPPPPPPPPPPPPPPPPPPPPPPPPPPPPPPPPPPPPPPPPPPPPPPPPPPPPPPPP