PPPPPPPPPPPPPPPPPPPPPPPPPPPPPPPPPPPPPPPPPPPPPPPPPPPPPPPPPPPPPPPPPPPPPPPPPPPPPPPPPPPPPPPPPPPPPPPPPPPPPPPPPPPPPPPPPPPPPPPP
P0000000000000000000000000000000000000000000000000000000000000000000000000000000000000000000000000000000000000000000000P
P0000000000000000000000000000000000000000000000000000000000000000000000000000000000000000000000000000000000000000000000P
P0000000000000000000000000000000000000000000000000000000000000000000000000000000000000000000000000000000000000000000000P
P00000000000000000000000000000000000000000000000T0000000000000000000000000000000000000000000000000000000000000000000000P
P00000000000000000000000000000000000T0000000000000000000000000000000000000000000000000000000000000000000000000000000000P
P0000000000000000000000T0000000000000000000000PPPPL0000000000000000000000000000000T0000000000T0000000000000000000000000P
P00000000000000T00000000000000000PPPPPPPL00000PPPPL00000000000000000000T00000000000000000000000000000000000000000000000P
PL0000000000000000000PPPPL0000000PPPPPPPL000PPPP00L0000000000000000000000000000PPPPPPPPPPPPPPPPPPL000000000000000000000P
PL00000000000LPPP0000PPPPL000T000PPPPPPPL000PPPP00L00000000T00000000000PL000000PPPPPPPPPPPPPPPPPPL000000000000T00000000P
PL00000000000L00000000000L0000000PPPPPPPL0000000T0L00000000000000PL00000L000000000000000000000000L00T000000000000000000P
PL00000000000PPP000000000PPPPPPPPPPPPPPPL000000000L00000000PL00000L00000L000000000000T00000000000L000000LPPPPPPPPPPPPPPP
PL000PPPPP000000000000000PPPPPPPPPPPPPPPL0000000PPPP00000000L00000L00000L000000000000000000000000LPPP000LPPPPPPPPPPPPPPP
PL000PPPPP00000000000000000000000PPPPPPPL0000000PPPP00000000L00000LPP000L000000000PPPPPPPPPPPP000LPPP000LPPPPPPPPPPPPPPP
PL0000000000000000000000000000000PPPPPPPL0000LPPPP0000000000L00000LPP000LPPPPP0000PPPPPPPPPPPP000L000000LPPPPPPPPPPPPPPP
PL0000000000000000000000000000000PPPPPPPL0000LPPPP000000000PPPPPP0LPP000L0000000000000PPPP0000000L000000LPPPPPPPPPPPPPPP
PL0000000000000000000000000000000PPPPPPPL0000L0000000000000PPPPPP0LPP000L0000000000000PPPP0000000L000000LPPPPPPPPPPPPPPP
PPPPPPPPPPPPPPPPPPPPPPPPPPPPPPPPPPPPPPPPPPPPPPPPPPPPPPPPPPPPPPPPPPPPPPPPPPPPPPPPPPPPPPPPPPPPPPPPPPPPPPPPPPPPPPPPPPPPPPPP