PPPPPPPPPPPPPPPPPPPPPPPP
000000000000000000000000
002000000000000000000000
000000000000000000000000
00PL00000000000000000000
00PL00000000000000000000
000L00000000000000100000
000LPP000000000000000000
000LPP00000000000PPPL000
000LPPPPPP0000000PPPL000
000LPPPPPP0000010000L030
000L0000000000000000L000
000L000000000LPPP000LPPP
000L000000000LPPP000LPPP
000L000000000LPPP000LPPP
000L000200PP0L000000LPPP
000L000000PP0L000000LPPP
PPPPPPPPPPPPPPPPPPPPPPPP