PPPPPPPPPPPPPPPPPPPPPPPP
000000000000000000000000
000000000000000200000000
000000000000000000000000
000000000PP000PPPPL00000
000000000PP000PPPPL00000
000000000000000000L00000
00PPPP000000200000L01000
00PPPP000000000000L00000
0000000000LPPPPPP0LPPP00
0000000000LPPPPPP0LPPP00
0000000000L0000000L00000
000000PP00L0100000L00000
000000PP00L0000000L00000
0LPPL00000LPPP0000L00000
0LPPL00000LPPP0000L03000
0LPPL00000LPPP0000L00000
PPPPPPPPPPPPPPPPPPPPPPPP