PPPPPPPPPPPPPPPPPPPPPPPP
000000000000000000000000
000000000000000020000000
000000000000000000000000
00000000000000PPPPL00000
00000000000000PPPPL00000
00200000010000PP00L00000
00000000000000PP00L00000
00PPP00LPPP0000000L00300
00PPP00LPPP0000000L00000
0000000L0000000000LPPPPP
0000000L0000000000LPPPPP
0000000L0000000000LPPPPP
0000000L0010PPL000LPPPPP
0000000L0000PPL000LPPPPP
00PPP00L0PPPPPL000LPPPPP
00PPP00L0PPPPPL000LPPPPP
PPPPPPPPPPPPPPPPPPPPPPPP