PPPPPPPPPPPPPPPPPPPPPPPP
000000000000000000000000
000000000000000000000000
000000000000000000000000
000001000000000000000000
000000000000000000000000
00PPPPPPL000000000000000
00PPPPPPL000010000000030
00000000L000000000000000
00000000L000PPPL0000LPPP
00000000L000PPPL0000LPPP
0000000LPPP0000L0020L000
0000000LPPP0000L0000L000
000LPPPL0000000L0PPPL000
000LPPPL00000PPL0PPPL000
000LPPPL02000PPL0PPPL000
000LPPPL00000PPL0PPPL000
PPPPPPPPPPPPPPPPPPPPPPPP