PPPPPPPPPPPPPPPPPPPPPPPP
000000000000000000000000
000000000000000000000000
000000000000000000000000
000000000000000000000000
0000000003000LPPP0000000
0000000000000LPPP0000000
000T000LPPP00L0000000200
0000000LPPP00L0000000000
00PPP00L00000L01000LPPP0
00PPP00L00000L00000LPPP0
0000000L02000LPPP00LPPP0
0000000L00000LPPP00LPPP0
0000000LPPP00LPPP00LPPP0
0000000LPPP00LPPP00LPPP0
00PPP00LPPP00LPPP00LPPP0
00PPP00LPPP00LPPP00LPPP0
PPPPPPPPPPPPPPPPPPPPPPPP