PPPPPPPPPPPPPPPPPPPPPPPP
000000000000000000000000
000000000100000000000000
000000000000000000000000
00PPPPL0PPP0000000000300
00PPPPL0PPP0000000000000
000000L000000000000PPPPP
000000L00000000PPL0PPPPP
000000L00000000PPL000000
000020L00000000PPL000000
000000L00PP000000L000000
0LPPPPPL0PP000000L000000
0LPPPPPL0000000T0L010000
0LPPPPPL000000000L000000
0LPPPPPL00000LPPPPPPPP00
0LPPPPPL00200LPPPPPPPP00
0LPPPPPL00000LPPPPPPPP00
PPPPPPPPPPPPPPPPPPPPPPPP