PPPPPPPPPPPPPPPPPPPPPPPP
000000000000000000000000
000000000100000000030000
000000000000000000000000
000000LPPPPP00000PPPPL00
000000LPPPPP00000PPPPL00
000000L00000000000000L00
000000L01000000000000L00
000000L00000000000000L00
00000LPPPPPPPPP000000LPP
00000LPPPPPPPPP000000LPP
00000L000000000000020L00
00P00L002000000000000L00
00P00L00000000000LPPPL00
0000LPPPPPP000000LPPPL00
0000LPPPPPP000000LPP0L00
0000L000000000000LPP0L00
PPPPPPPPPPPPPPPPPPPPPPPP