PPPPPPPPPPPPPPPPPPPPPPPP
000000000000000000000000
000000000000000000000000
003000000000000000000000
000000000000010000000000
00PPL0000000000000000000
00PPL000LPPPPPPPPPPPPPPP
0000L000LPPPPPPPPPPPPPPP
0000L000L000000000000000
0000L000L000000000000000
0000L000L000000000000020
0000L000L000000000000000
00PPL00LPPPPPPPPPPPPPPPP
00PPL00LPPPPPPPPPPPPPPPP
0000L00L0000000000000000
0300L00L0000000001000000
0000L00L0000000000000000
PPPPPPPPPPPPPPPPPPPPPPPP