PPPPPPPPPPPPPPPPPPPPPPPP
000000000000000000000000
000000000000000000000000
000000000000000000000000
000000000000000020000000
000000000000000000000000
00000000LPPPPPPPPPPL0PP0
00000000LPPPPPPPPPPL0PP0
00000000L0000000000L0000
00010000L0000000000L0300
00000000L0200000000L0000
0LPPP000L0000000000LPPP0
0LPPP000LPPPP000000LPPP0
0L000PP0LPPPP00PP00LPPP0
0L000PP0L000000PP00LPPP0
0L000PP0L0010PPPP00LPPP0
0L000PP0L0000PPPP00LPPP0
PPPPPPPPPPPPPPPPPPPPPPPP