PPPPPPPPPPPPPPPPPPPPPPPP
000000000000000000000000
003000000000000000000000
000000000000000000000000
00PPL0000001000000000000
00PPL00000000000PPL00000
0000L0000PPPP000PPL00000
0000L0000PPPP00000L00020
0000L0000000000000L00000
0000L0000000000000L0LPPP
0000L0001000000020L0LPPP
0000L0000000000000L0LPPP
000LPPPPPPP0000PPPP0LPPP
000LPPPPPPP0000PPPP0LPPP
000LPP000000000PPPP0LPPP
000LPP000000000PPPP0LPPP
000LPP000000000PPPP0LPPP
PPPPPPPPPPPPPPPPPPPPPPPP