PPPPPPPPPPPPPPPPPPPPPPPP
000000000000000000000000
003000000000000000000000
000000000000000000000000
00P000010000000000000000
00P000000000000000000LPP
0000LPPPPPP0000000020LPP
0000LPPPPPP0000000000L00
0000LPP000000000LPPPPL00
0000LPP000000000LPPPPL00
0000LPP000003000LPPPPL00
0000L00000000000LPPPPL00
0000L000000PPP00LPPPPL00
0000L000010PPP00LPPPPL00
0000L000000PPP00LPPPPL00
0000L00PPPPPPP00LPPPPL00
0000L00PPPPPPP00LPPPPL00
PPPPPPPPPPPPPPPPPPPPPPPP