PPPPPPPPPPPPPPPPPPPPPPPP
000000000000000000000000
000000000000000000000000
000000200000000000000000
000000000000003000000000
000LPPPPP000000000000000
000LPPPPP000PPPPL0000000
000L00000000PPPPL0000000
000L000000000000L0000000
000L000000000000L0200000
00PL000000000000L0000000
00PL0000100000LPPPPP0000
000L0000000000LPPPPP0000
000L000PPPPL00LPP0000000
000L000PPPPL00LPP0000LPP
000L0000010L00LPP0000LPP
000L0000000L00LPP0000LPP
PPPPPPPPPPPPPPPPPPPPPPPP